11111111111
1E000001001
10100011101
1P00C000001
11111111111