111111111111111
1E000000C000001
101001010010001
101001001010101
1P0000000000001
100000000000001
111111111111111
